NO ./images/NO.xpm
SO ./images/SO.xpm
WE ./images/WE.xpm
EA ./images/EA.xpm

F 0,100,0
C 100,100,255

        1111111111111111111111111
        1000000000000000000000001
        1100000000001111001110001
        1000000000001001001010001
111111111000000000001001111010001
100000000000000000001000000111111
10000000000000E00000100000001
10000000000000000000100000001
10000000000000000000100000001
10000000000000000000000000001
10000000000000000001010000001
11000001110101011111011110101
11110111 1110111 101111010001
11111111 1111111 111111111111
